NO ./textures/CRATE_1D.png
SO ./textures/BRICK_6D.png
WE ./textures/CONSOLE_1B.png
EA ./textures/PIPES_1A.png

F 220,100,0
C 225,30,0

        1111111111111111111111110
        1000000000110000000000001
        1011000000000100000000001
        1001000000000010000000001
111111111011000001110000000000001
100000000011000001110111110111111
11100111111110111000000100001
11110111111111011101010010001
11000000110101011100000010001
100000000000000011000000D0001
10000000000000001101010011011
11000001110101011111011110N01
11110111111010101101111010001
11111111 1111111 111111111111