NO ./textures/BRICK_6D.png
SO ./textures/CONSOLE_1B.png
WE ./textures/DOOR_4A.png
EA ./textures/LIGHT_1B.png

F 220,100,0
C 225,30,0

        1111111111111111111111111
        1000000000110000000000001
        1011000001110000000000001
        1001000000000000000000001
111111111011000001110000000000001
100000000011000001110111101111111
11110111111111011100000010001
11110111111111011101010010001
11000000110101011100000010000
10000000000000001100000010000
1000000000000000110101001000N
1100000111010101111101111000111
11110111 1110100 101111010001
11111111 1111111 111111111111